NO ./textures/NO.xpm
SO ./textures/SO.xpm
WE ./textures/WE.xpm
EA ./textures/EA.xpm

F 255,100,0      
C 225,30,0        

        1111111111111111111111111
        1000000000110000000000001
        1011000001110000000000001
        100100W000000000000000001        
111111111011000001110000000000001       
100000000011000001110111111111111   
11110111111111011100000010001
111101111111110111010100100011     
11000000110101011100000010001
10000000000000001100000010001
10000000000000001101010010001
11000001110101011111011110001111111111
11110111 1110101 101111010001
11111111 1111111 111111111111
11111111 1111111 111111111111
11111111 1111111 111111111111
11111111 1111111 111111111111
11111111 1111111 11111111111
11111111 1111111 111111111111
11111111 1111111 11111111
11
                                           11




