NO ../sprites/textures/NO.xpm
SO ../sprites/textures/SO.xpm
WE ../sprites/textures/WE.xpm
EA ../sprites/textures/EA.xpm

F 220,100,0
C 225,30,0










111111101011001010101010101010101010101010










