NO ./textures/NO.xpm      
SO ./textures/SO.xpm     
WE ./textures/WE.xpm             
EA ./textures/EA.xpm

F 154,85,85
C 0,0,0

1111111111111111111111111111111111111111111111111111111111111111111111111111111111111111111111111
1100000000000000000000000000000000000000000000011110000000000000000000000000000000000000000000011
1100000000000000000000000000000000000000000000011100000000000000000000000000000000000000000000001
1100000000000000000000000000000000000000000000011100000000000000000000000000000000000000000000001
1100000000000000000000000000000000000000000000011100000000000000000000000000000000000000000000001
1100000000000000000000000000000000000000000000011100000000000000000000000000000000000000000000001
1100000000000000000000000000000000000000000000011100000000000000000000000000000000000000000000001
1100000000000000000000000000000000000000000000011100000000000000000000000000000000000000000000001
1100000000111111110000000001111111111110000000011100000000011111111111000000000111111110000000001
1100000001        100000001            10000000111000000001           100000001        1000000001
1100000001        100000001            10000000111000000001           100000001        1000000001
1100000001        100000001            10000000111000000001           100000001        1000000001
1100000001        100000001            10000000111000000001           100000001        1000000001
1100000000111111110000000001111111111110000000001100000000011111111111000000000111111110000000001
1100000000000000000000000000000000000000000000000000000000000000000000000000000000000000000000001
1100000000000000000000000000000000000000000000000000000000000000000000000000000000000000000000001
1100000000000000000000000000000000000000000000000000000000000000000000000000000000000000000000001
1100000000000000000000000000000000000000000000000000000000000000000000000000000000000000000000001
1100000000000000000000000000000000000000000000000000000000000000000000000000000000000000000000001
1100000000000000000000000000000000000000000000000000000000000000000000000000000000000000000000001
1100000000000000000000000000000000000000000000000000000000000000000000000000000000000000000000001
1100000000111111110000000001100000000011111111111111111111110000000011100000000111111110000000001
1100000001        10000000111100000001                      1000000011100000001        1000000001
1100000000111111110000000011110000000011111111111111111111110000000011100000000111111110000000001
1100000000000000000000000011110000000000000000011100000000000000000011100000000000000000000000001
1100000000000000000000000011110000000000000000011100000000000000000011100000000000000000000000001
1100000000000000000000000011110000000000000000011100000000000000000011100000000000000000000000001
1100000000000000000000000011110000000000000000011100000000000000000011100000000000000000000000001
1100000000000000000000000011110000000000000000011100000000000000000011100000000000000000000000001
1100000000000000000000000011110000000000000000011100000000000000000011100000000000000000000000011
1111111111111111111000000011111111111110000000011100000000111111111111100000000111111111111111111
1111111111111111111000000011111111111111000000011100000000111111111111100000001111111111111111111
                  10000000111111111111100000000011000000001111111111111000000011
                  10000000111100000000000000000000000000000000000000111000000011
                  10000000111100000000000000000000000000000000000000111000000011
                  10000000111100000000000000000000000000000000000000111000000011
                  10000000111100000000000000000000000000000000000000111000000011
                  10000000111100000000000000000000000000000000000000111000000011
                  10000000111100000000000000000000000000000000000000111000000011
                  10000000111100000000000000000000000000000000000000111000000011
                  10000000111100000001111111110000011111111110000000111000000011
1111111111111111111000000001100000000100000000000000000000011000000011100000001111111111111111111
1000000000000000000000000000000000000100000000000000000000011000000000000000000000000000000000001
1000000000000000000000000000000000000100000000000000000000011000000000000000000000000000000000001
1000000000000000000000000000000000000100000000000000000000011000000000000000000000000000000000001
1000000000000000000000000000000000000100000000000000000000011000000000000000000000000000000000001
1000000000000000000000000000000000000100000000000000000000011000000000000000000000000000000000001
1000000000000000000000000000000000000100000000000000000000011000000000000000000000000000000000001
1000000000000000000000000000000000000100000000000000000000011000000000000000000000000000000000001
1111111111111111111000000001100000000100000000000000000000011000000001100000000111111111111111111
1111111111111111111000000011110000000100000000000000000000011000000011100000001111111111111111111
                  10000000111100000001111111110000011111111110000000111000000011
                  10000000111100000000000000000000000000000000000000111000000011
                  10000000111100000000000000000000000000000000000000111000000011
                  10000000111100000000000000000000000000000000000000111000000011
                  10000000111100000000000000000000000000000000000000111000000011
                  10000000111100000000000000000000000000000000000000111000000011
                  10000000111100000000000000000000000000000000000000111000000011
                  10000000111100000000000000000000000000000000000000111000000011
                  10000000111100000001111111111111111111111100000000111000000011
 11111111111111111100000000111000000011111111111111111111111100000001110000000111111111111111111
1111111111111111110000000000000000000011111111111111111111100000000001000000000011111111111111111
1100000000000000000000000000000000000000000000011100000000000000000000000000000000000000000000001
1100000000000000000000000000000000000000000000011100000000000000000000000000000000000000000000001
1100000000000000000000000000000000000000000000011100000000000000000000000000000000000000000000001
1100000000000000000000000000000000000000000000011100000000000000000000000000000000000000000000001
1100000000000000000000000000000000000000000000011100000000000000000000000000000000000000000000001
1100000000000000000000000000000000000000000000011100000000000000000000000000000000000000000000001
1100000000111111111000000001111111111110000000011100000000111111111111000000000111111111000000001
1100000001111111111000000011111111111111000000011100000000111111111111100000001111111111000000001
1100000000111111111000000001111111111111000000001100000000111111111111100000001111111111000000001
1100000000000000111000000000000000000000000000000000000000000000000000000000001111000000000000001
1100000000000000111000000000000000000000000000000000000000000000000000000000001110000000000000001
1100000000000000111000000000000000000000000000000000000000000000000000000000001110000000000000001
110000000000000011100000000000000000000000000W000000000000000000000000000000001110000000000000001
1100000000000000111000000000000000000000000000000000000000000000000000000000001110000000000000001
1100000000000000111000000000000000000000000000000000000000000000000000000000001110000000000000001
1100000000000000111000000000000000000000000000000000000000000000000000000000001110000000000000011
1111111110000000111000000001100000000111111111111111111111110000000011100000001110000000011111111
1111111110000000111000000011110000000111111111111111111111111000000011100000001110000000011111111
1110000000000000000000000011110000000000000000111110000000000000000011100000000000000000000000011
1100000000000000000000000011110000000000000000011100000000000000000011100000000000000000000000001
1100000000000000000000000011110000000000000000011100000000000000000011100000000000000000000000001
1100000000000000000000000011110000000000000000011100000000000000000011100000000000000000000000001
1100000000000000000000000011110000000000000000011100000000000000000011100000000000000000000000001
1100000000000000000000000011110000000000000000011100000000000000000011100000000000000000000000001
1100000000000000000000000011110000000000000000011100000000000000000011100000000000000000000000001
1100000000111111111111111111111111111110000000011100000000111111111111111111111111111111000000001
1100000001111111111111111111111111111111000000011100000000111111111111111111111111111111000000001
1100000000111111111111111111111111111111000000011100000000111111111111111111111111111111000000001
1100000000000000000000000000000000000000000000000000000000000000000000000000000000000000000000001
1100000000000000000000000000000000000000000000000000000000000000000000000000000000000000000000001
1100000000000000000000000000000000000000000000000000000000000000000000000000000000000000000000001
1100000000000000000000000000000000000000000000000000000000000000000000000000000000000000000000001
1100000000000000000000000000000000000000000000000000000000000000000000000000000000000000000000001
1100000000000000000000000000000000000000000000000000000000000000000000000000000000000000000000001
1110000000000000000000000000000000000000000000000000000000000000000000000000000000000000000000011
1111111111111111111111111111111111111111111111111111111111111111111111111111111111111111111111111